486 178
6 5
0 0 0 1 1 1
0 0 0 1 6 1
1 1 3 4 4 2
1 1 1 1 1 6
0 0 0 1 1 1