544 142
6 5
0 1 1 1 0
0 1 1 3 0
1 1 1 3 0
0 0 1 1 1
0 0 1 2 1
0 0 0 1 1