0 0 1 1 0 0 0
0 4 4 1 1 1 0
0 1 1 1 5 5 2
1 1 1 1 5 5 1
1 1 1 1 0 0 0