496 105
6 7
0 0 1 1 1 0
0 0 1 5 5 0
0 0 1 5 5 0
0 1 4 4 1 1
1 1 1 1 1 1
0 1 1 1 1 1
0 0 2 0 0 0