510 200
6 5
0 0 0 1 1 1
1 3 1 1 3 2
1 1 6 1 3 0
0 0 1 1 1 0
0 0 0 1 0 0