445 196
5 7
0 0 1 1 3 1 1
0 0 1 1 1 1 3
1 1 1 2 0 1 1
0 0 0 1 3 1 1
0 0 0 0 1 1 1