560 167
5 5
0 1 2 0 0
0 1 3 0 0
1 1 1 1 1
1 1 3 0 1
1 1 3 1 1